NO assets/cavern/cavern_N.png
SO assets/cavern/cavern_S.png
WE assets/cavern/cavern_W.png
EA assets/cavern/cavern_E.png

F 82,75,36
C 50,60,57

111111111111
110000000011
10000S000001
100000000111
1000000011              111111111111111
111000011             11100000000000011
  100001          111110000000000000001
  100011        1110000000011111000000111
  1100011       11000000000111 1110000001
   1000111      110000011000011 1100000011
   111000111  1110000001100001111000000011
    1110000111100001100000000000000011111
     11000000000000000000000000000111
      11100111110000000000000011111
        11011111000001100001111
         1111111111111111111
