NO assets/textures/Impression_Sunrise.png
SO assets/textures/Sunflowers.png
WE assets/textures/the_starry_night.png
EA assets/textures/115.png

F 220,100,10
C 225,30,000

                       111
                     1101011
                   11000100011
                 110000010000011
               1100000001000000011
             11000000000100000000011
           110000000000010000000000011
         1100000000000001000000000000011
       11000000000000000100000000000000011
     1100000000000000000S0000000000000000011
   1100000000000000000110110000000000000000011
 11000000000000000000110001100000000000000000011
 110000000000000000000000000000000000000000000011
 11000000000000000000000000000000000000000000011
   1100000000000000000000000000000000000000011
     110000000000000000000000000000000000011
       11000000000000000000000000000000011
         1100000000000000000000000000011
           110000000000000000000000011
             11000000000000000000011
               1100000000000000011
                 110000000000011
                   11000000011
                     1100011
                       111
