NO ./assets/textures/Impression_Sunrise.png
SO ./assets/textures/Sunflowers.png
WE ./assets/textures/the_starry_night.png
EA ./assets/textures/115.png

F 220,100,0
C 225,30,000

                       111
                     1100011
                   11000000011
                 110000000000011
               1100000000000000011
             11000000000000000000011
           110000000000000000000000011
         1100000000000000000000000000011
       11000000000000000000000000000000011
     110000000000000000000000000000000000011
   1100000000000000000000000000000000000000011
 11000000000000000000000000000000000000000000011
 11000000000000000000000N00000000000000000000011
 11000000000000000000000000000000000000000000011
   1100000000000000000000000000000000000000011
     110000000000000000000000000000000000011
       11000000000000000000000000000000011
         1100000000000000000000000000011
           110000000000000000000000011
             11000000000000000000011
               1100000000000000011
                 110000000000011
                   11000000011
                     1100011
                       111
