NO assets/textures/Impression_Sunrise.png
SO assets/textures/Sunflowers.png
WE assets/textures/the_starry_night.png
EA assets/textures/115.png

F 220,100,10
C 225,30,000

1111111111
1110101111
1000010001
1001100001
1001000001
10000S0001
1001000101
1101111101
1111 1111