NO assets/textures/Impression_Sunrise.png
SO assets/textures/the_scream.png
WE assets/textures/Mona_Lisa.png
EA assets/textures/Wheat_Field.png

F 200,125,005
C 230,020,100

        11111111111111111111111111
        10000000001100000000000011
        10110000011100000000000011
1111111110010000000000000000000011
1111101111011000001110000000000001
110000000001100S001110111111111111
1111101111111110111000000100011111
1111101111111110111010100100011111
1110000011101010111000000100011111
1100000010000000110000001000111111
1100000000010100110101001000111111
1110000011101010111110111000001111
11111011   11010111011110100011111
1111111111111111111111111111111111
