NO assets/textures/Impression_Sunrise.png
SO assets/textures/the_scream.png
WE assets/textures/Mona_Lisa.png
EA assets/textures/Wheat_Field.png

F 255,255,255
C 000,000,000

        1111111111111111111111111
        1000000000110000000000001
        1011000001110000000000001
  11111 1001000000000000000000001
111101111011000001110000000000001
1000000000110000011101111111111111
11110111111111011100000010001
11110111111111011101010010001
11000000110101011100000010001
1000000E000000001100000010001
100000000000000011010100100011
1100000111010101111101110000011
11110111 1110101 1011110100011
11111111 1111111 111111111111
                  
111111111111111111111111111
111111111111111111111111111