NO assets/textures/Impression_Sunrise.png
SO assets/textures/Sunflowers.png
WE assets/textures/the_starry_night.png
EA assets/textures/115.png

F 220,100,10
C 225,30,000

11111111111111111111111111111111111111111111111
11111111111111111111111111111111111111111111111
11000000000000000000000000000000000000000000011
11000000000000000000000000000000000000000000011
11000000000000000000000000000000000000000000011
11000000000000000000000000000000000000000000011
11000000000000000000000000000000000000000000011
11000000000000000000000000000000000000000000011
11000000000000000000000000000000000000000000011
11000000000000000000000000000000000000000000011
11000000000000000000000000000000000000000000011
11000000000000000000000000000000000000000000011
11000000000000000000000000000000000000000000011
11000000000000000010000000000000000000000000011
11000000000000000000000000000000000000000000011
1100000000000000N000000000000000000000000000011
11000000000000000000000000000000000000000000011
11000000000000000000000000000000000000000000011
11000000000000000000000000000000000000000000011
11000000000000000000000000000000000000000000011
11000000000000000000000000000000000000000000011
11000000000000000000000000000000000000000000011
11000000000000000000000000000000000000000000011
11000000000000000000000000000000000000000000011
11000000000000000000000000000000000000000000011
11000000000000000000000000000000000000000000011
11000000000000000000000000000000000000000000011
11000000000000000000000000000000000000000000011
11000000000000000000000000000000000000000000011
11000000000000000000000000000000000000000000011
11000000000000000000000000000000000000000000011
11000000000000000000000000000000000000000000011
11000000000000000000000000000000000000000000011
11000000000000000000000000000000000000000000011
11000000000000000000000000000000000000000000011
11000000000000000000000000000000000000000000011
11000000000000000000000000000000000000000000011
11000000000000000000000000000000000000000000011
11000000000000000000000000000000000000000000011
11000000000000000000000000000000000000000000011
11000000000000000000000000000000000000000000011
11000000000000000000000000000000000000000000E11
11111111111111111111111111111111111111111111111
11111111111111111111111111111111111111111111111