
SO assets/textures/seamless_stone.png
NO assets/textures/Mona_Lisa.png
WE assets/textures/the_tower_of_babel.png
EA assets/textures/the_starry_night.png

F 100,100,100
C 100,100,100

1111
1001
1N01
1111